111111111111111
100000000000111
100EPC000000001
111111111111111
