11111111111111111111111
10000100001ECCCCC000P01
1111111111111111111111
