1111111111111111
10000CCCCEP00001
1111111111111111
