111111111111111
1000001000P0CC1
100E0C0G0C0V001
111111111111111
