111111111111111111111111
10E0000C101CCCC000000G11
100000V00000V0000C0000G1
1C1C1C10000PCG000010C101
111111111111111111111111
